16 16
OOOOOOOOOOOOOOOO
----------------
----------#-----
----------------
---#------------
----------------
----------------
----------------
----------------
----------------
----------------
----------------
----------------
----------------
----------------
---------------O