8 8
-#------
----#---
--------
---#----
#-------
--------
--------
--------