10 10
--#---#---
#--#---#-#
--#--#----
O--------O
OO-#-O-#-O
OO---O---O
---#---#--
#--#--#--#
----#-----
-#----O-#-