16 16
----OO--------#-
---------#------
----------#-----
#---------------
-----#-----#---#
---------------#
----------------
-------#--------
----------------
---#------#-----
--------------#-
-#-----------#--
--#--#---#------
#-------#-----##
--#-------##--##
----------####-#