16 16
-----------------
#--#---#-#-------
----------#------
-------O---------
---#-------------
---O-#--O--#-----
---#-------------
#--#--#-------#-#
----#---------#--
-#------#----#---
-----------------
--#--#---#-------
#-------#-----##-
-----------------
--#-------#######
----------#######
