18 18
---##---------#---
----------####-#--
---------#--------
#-----------------
--#--#---#--------
-----#-----#---#--
---------------#--
----------#-------
OO----------------
----------####-#--
------------------
--------#---------
---#--------------
--------------#---
----------####-#--
-#-----------#----
#-------#-----##--
--#-------##--##--