18 18
------------------
#--#---#-#--------
----------#---##--
------------------
---#----------###-
-----#-----#--#---
---#----------###-
#--#--#--#----#-#-
----#----#----#--#
-#------#----#----
------------------
--#--#---#-------#
#-------#-----##--
------------------
--#-------OOOOOOOO
----------OOOOOOOO
------------------
#--#-#-#----------