10 10
-----------
#--#---#-#-
----------#
-------O---
---#-------
---O-#--O--
---#-------
#--#--#----
----#------
-#------#--