18 18
------------------
#--#---#-#--------
----------#---##--
------------------
---#----------###-
-----#-----#--#---
---#----------###-
#--#----------#-#-
--------------#--#
-#-----------#----
------------------
--#--#---#-------#
#-------#-----##--
------------------
--#---------------
------------------
------------------
#--#-#-#----OOOOOO